XXXGXXXXXXXXXXXXXXXGXXXXXXXXXXXX
XOXPPPXXXXXXXXOXXOXPPPXXXXXXXXOX
XXXXXPPPXXXXXXXXXXXXXPPPXXXXXXXX
XXXXXOXPPPXXXXXXXXXXXOXPPPXXXXXX
XXOXXXXXXPPPPPPXXXOXXXXXXPPPPPPX
XXXXXXXXXXOXXXPXXXXXXXXXXXOXXXPX
XXXXXXXXXXOXXXPXXXXXXXXXXXOXXXPX
XXXOXXXXXXOXXXPXXXXOXXXXXXOXXXPX
XXXXXXXXXXOXXPPXXXXXXXXXXXOXXPPX
XXXXXXXXXXXXPPXXXXXXXXXXXXXXPPXX
XXXXXXXXXXXXPXXXXXXXXXXXXXXXPXXX
GXXXXXXXXXXXPPPEGXXXXXXXXXXXPPPE
XOXPPPXXXXXXXXOXXOXPPPXXXXXXXXOX
XXXXXPPPXXXXXXXXXXXXXPPPXXXXXXXX
XXXXXOXPPPXXXXXXXXXXXOXPPPXXXXXX
XXOXXXXXXPPPPPPXXXOXXXXXXPPPPPPX
XXXXXXXXXXOXXXPXXXXXXXXXXXOXXXPX
XXXXXXXXXXOXXXPXXXXXXXXXXXOXXXPX
XXXOXXXXXXOXXXPXXXXOXXXXXXOXXXPX
XXXXXXXXXXOXXPPXXXXXXXXXXXOXXPPX
XXXXXXXXXXXXPPXXXXXXXXXXXXXXPPXX
XXXXXXXXXXXEPXXXXXXXXXXXXXXEPXXX