XXXGXXXXXXXXXXXXXOXPPPXXXXXXXXOX
XOXPPPXXXXXXXXOXXOXPPPXXXXXXXXOX
XXXXXPPPXXXXXXXXXOXPPPXXXXXXXXOX
XXXXXOXPPPXXXXXXXOXPPPXXXXXXXXOX
XXOXXXXXXPPPPPPXXOXPPPXXXXXXXXOX
XXXXXXXXXXOXXXPXXOXPPPXXXXXXXXOX
XXXXXXXXXXOXXXPXXOXPPPXXXXXXXXOX
XXXOXXXXXXOXXXPXXOXPPPXXXXXXXXOX
XXXXXXXXXXOXXPPXXOXPPPXXXXXXXXOX
XXXXXXXXXXXXPPXXXOXPPPXXXXXXXXOX
XXXXXXXXXXXXPXXXXOXPPPXXXXXXXXOX
GXXXXXXXXXXXPPPEXOXPPPXXXXXXXXOX
XOXPPPXXXXXXXXOXXOXPPPXXXXXXXXOX
XXXXXPPPXXXXXXXXXOXPPPXXXXXXXXOX
XXXXXOXPPPXXXXXXXOXPPPXXXXXXXXOX
XXOXXXXXXPPPPPPXXOXPPPXXXXXXXXOX
XXXXXXXXXXOXXXPXXOXPPPXXXXXXXXOX
XXXXXXXXXXOXXXPXXOXPPPXXXXXXXXOX
XXXOXXXXXXOXXXPXXOXPPPXXXXXXXXOX
XXXXXXXXXXOXXPPXXOXPPPXXXXXXXXOX
XXXXXXXXXXXXPPXXXOXPPPXXXXXXXXOX
XXXXXXXXXXXEPXXXXOXPPPXXXXXXXXOX
XXXGXXXXXXXXXXXXXOXPPPXXXXXXXXOX
XOXPPPXXXXXXXXOXXOXPPPXXXXXXXXOX
XXXXXPPPXXXXXXXXXOXPPPXXXXXXXXOX
XXXXXOXPPPXXXXXXXOXPPPXXXXXXXXOX
XXOXXXXXXPPPPPPXXOXPPPXXXXXXXXOX
XXXXXXXXXXOXXXPXXOXPPPXXXXXXXXOX
XXXXXXXXXXOXXXPXXOXPPPXXXXXXXXOX
XXXOXXXXXXOXXXPXXOXPPPXXXXXXXXOX
XXXXXXXXXXOXXPPXXOXPPPXXXXXXXXOX
XXXXXXXXXXXXPPXXXOXPPPXXXXXXXXOX
XXXXXXXXXXXXPXXXXOXPPPXXXXXXXXOX
GXXXXXXXXXXXPPPEXOXPPPXXXXXXXXOX
XOXPPPXXXXXXXXOXXOXPPPXXXXXXXXOX
XXXXXPPPXXXXXXXXXOXPPPXXXXXXXXOX
XXXXXOXPPPXXXXXXXOXPPPXXXXXXXXOX
XXOXXXXXXPPPPPPXXOXPPPXXXXXXXXOX
XXXXXXXXXXOXXXPXXOXPPPXXXXXXXXOX
XXXXXXXXXXOXXXPXXOXPPPXXXXXXXXOX
XXXOXXXXXXOXXXPXXOXPPPXXXXXXXXOX
XXXXXXXXXXOXXPPXXOXPPPXXXXXXXXOX
XXXXXXXXXXXXPPXXXOXPPPXXXXXXXXOX
XXXXXXXXXXXEPXXXXOXPPPXXXXXXXXOX
XXXGXXXXXXXXXXXXXOXPPPXXXXXXXXOX
XOXPPPXXXXXXXXOXXOXPPPXXXXXXXXOX
XXXXXPPPXXXXXXXXXOXPPPXXXXXXXXOX
XXXXXOXPPPXXXXXXXOXPPPXXXXXXXXOX
XXOXXXXXXPPPPPPXXOXPPPXXXXXXXXOX
XXXXXXXXXXOXXXPXXOXPPPXXXXXXXXOX
XXXXXXXXXXOXXXPXXOXPPPXXXXXXXXOX
XXXOXXXXXXOXXXPXXOXPPPXXXXXXXXOX
XXXXXXXXXXOXXPPXXOXPPPXXXXXXXXOX
XXXXXXXXXXXXPPXXXOXPPPXXXXXXXXOX
XXXXXXXXXXXXPXXXXOXPPPXXXXXXXXOX
GXXXXXXXXXXXPPPEXOXPPPXXXXXXXXOX
XOXPPPXXXXXXXXOXXOXPPPXXXXXXXXOX
XXXXXPPPXXXXXXXXXOXPPPXXXXXXXXOX
XXXXXOXPPPXXXXXXXOXPPPXXXXXXXXOX
XXOXXXXXXPPPPPPXXOXPPPXXXXXXXXOX
XXXXXXXXXXOXXXPXXOXPPPXXXXXXXXOX
XXXXXXXXXXOXXXPXXOXPPPXXXXXXXXOX
XXXOXXXXXXOXXXPXXOXPPPXXXXXXXXOX
XXXXXXXXXXOXXPPXXOXPPPXXXXXXXXOX
XXXXXXXXXXXXPPXXXOXPPPXXXXXXXXOX
XXXXXXXXXXXEPXXXXOXPPPXXXXXXXXOX