XXXGXXXXXXXXXXXX
XOXPPPXXXXXXXXOX
XXXXXPPPXXXXXXXX
XXXXXOXPPPXXXXXX
XXOXXXXXXPPPPPPX
XXXXXXXXXXOXXXPX
XXXXXXXXXXOXXXPX
XXXXXXXXXXOXXXPX