XXXGXXXXXXXXXXXX
XOXPPPXXXXXXXXOX
XXXXXPPPXXXXXXXX
XXXXXOXPPPXXXXXX
XXOXXXXXXPPPPPPX
XXXXXXXXXXOXXXPX
XXXXXXXXXXOXXXPX
XXXOXXXXXXOXXXPX
XXXXXXXXXXOXXPPX
XXXXXXXXXXXXPPXX
XXXXXXXXXXXRPXXX