XXXGXXXXXXXXXXXX
XXXXPXXXXXXXXXXX
XXXXXPPXXXXXXXXX
XXXXXXXPPPXXXXXX
XXXXXXXXXXPPPPXX
XXXXXXXXXXXXXXPE