XXXXGXXTXXXXXTRR
XXTXPXXXXPXRXRRT
XRXXPXXXTPXXXXRR
XXXXPXXXXPXXXXXR
XXXXPPPPPPXXXTXR
TXXXXPXXXPPPPXXX
XXXXTPXTXXXXPXXX
XXXXXPXXXXXXPXXX
XXTXXPXXXTXXPXXX
RXXXXPXXXXXXPPPE
XXTXXPXXXTXXPXXX
XXTXXPXPPPPPPPPE
TTTXXPPPXXXXXXXR
TTXTXPTPXXPPXXXX
EPPPPPTPXXPPPPXX
TXTTTXTGXXERXPPG
