XXXXGXXXXXXXXXXX
XXXXPXXXXXXXXXXX
XXXXPXXXXXXXXXXX
XXXXPXXXXXXXXXXX
XXXXPPPPPPXXXXXX
XXXXXPXXXPPPPXXX
XXXXXPXXXXXXPXXX
XXXXXPXXXXXXPXXX
XXXXXPXXXXXXPXXX
XXXXXPXXXXXXPPPE
XXXXXPXXXXXXPXXX
XXXXXPXPPPPPPPPE
XXXXXPPPXXXXXXXX
XXXXXPXPXXXXXXXX
EPPPPPXPXXXXXXXX
XXXXXXXGXXXXXXXX