XXXXGXXOXXXXXOXX
XXTXPXXXXXXXXXXX
XRXXPXXXOXXXXXRX
XXXXPXXXXXXXXXXX
XXXXPPPPPPXXXTXX
OXXXXPXXXPPPPXXX
XXXXOPXOXXXXPXXX
XXXXXPXXXXXXPXXX
XXOXXPXXXOXXPXXX
RXXXXPXXXXXXPPPE
XXTXXPXXXOXXPXXX
XXOXXPXPPPPPPPPE
XXXXXPPPXXXXXXXX
XOXXXPXPXXXXOXXX
EPPPPPXPXXRXXXXX
OXXOOXXGXXXRTEPG