XXXXGXXOXXXXXOXX
XXXXPXXXXXXXXXXX
XXXXPXXXOXXXXXXX
XXXXPXXXXXXXXXXX
XXXXPPPPPPXXXXXX
OXXXXPXXXPPPPXXX
XXXXOPXOXXXXPXXX
XXXXXPXXXXXXPXXX
XXOXXPXXXOXXPXXX
XXXXXPXXXXXXPPPE
XXXXXPXXXOXXPXXX
XXOXXPXPPPPPPPPE
XXXXXPPPXXXXXXXX
XOXXXPXPXXXXOXXX
EPPPPPXPXXXXXXXX
OXXOOXXGXXXXXEPG