XXXXXXXXXTTTTTTTTTTGTTTTTXXXXTTTTTTTTTTT
XXXXXXXTXXXXXXTTTTTPTTTXXXXXXXTTTTTTTTTT
XXXXXXTTTXXXXXXTTTTPTTTXXXXXXXXXXTTTTTTT
XXXXXTTTTTXXXXXXXTTPTTXXXXXXXXXXXXXTTTTT
XXXXXXTTTTXXXXXXXXXPXXXXXXXXXXXXXXXXXTTX
XXXXXXXXTTXXXXXXXXXPXXXXXXXXXXXXXXXXXXXX
XXXTXXXTXXXXXXXXXXXPXXXXXXXXXXXRXXXXXXXX
TTTRTXXXXXXXXXXXXXXPXXXXXXXXXXXXXXXXXXXX
TTRRTTXXXXXXXXXXXXXPXXXXXXXXXXXXXXXXXXXX
XTTRXXXXXPPPPPPPPPPPPPPPPPPPPPXXXXXXXXXX
XXXXXXXXXPXXXXXXXXXXXXXXXXXXXPXXXXXXXXXX
XXXXXXXXXPXXXXXXXXXXXXXXXXXXTPTTXXXXXXXX
XXXXXXXXXPXXXXXXXXXXXXXXXXXXRRRTXXXXXXXX
XXXXXXXXXPXXXXXXXXXXXXXXXXXTXRXTXXXXXXXX
XXXXXXXXXPXXXXXXXXXTTXXXXXXXXTXXXXXXXXXX
XTXXXXXXXPXXXXXXXXTTRTXXXXXXXXXXXXXXXXXX
XXXXTXXXXPXXXXXXXXXTXXXXXXXXXXXXXXXXXXXX
XRTXTXXXXPXXXXXXXXXXXXXXXXXXXXXXXXXXXXXX
XTXXXXXXXPXXXXXXXXXXXXXXXXXXXXXXXXXXXXXX
GPPPPPPPPPXXXXXXXXXXXXXXXXXXXPPPPPPPPPPE
XXXXXXXXXPXXXXXXXXXXXXXXXXXXXPXXXXXXXXXX
XTRTTXXXXPXXXXXXXXXXXTTXXXXXXPXXXXXXXTTT
XTRRXXXXXPXXXXXXXXXTTTRPPPPPPPPPPPPPTTTT
XXTTXXXXXPXXXXXXXXXTXTTXXXXXXPXXXXXXXTTT
XXXXXXXXXPXXXXXXXXXXXXXXXXXXXPXXXXXXXXXX
XXXXXXXXXPXXXXXXXXXTXTXXXXXXXPXXXXXXXXXX
XXXXXXXXXPXXXXXXXTTRTTXXXXXXXPXXXXXXXXXX
XXXXXXXXXPXXXXXXXXTXTXXXXXXXXPXXXXXXXXXX
XXXXXXXXXPXXXXXXXXXXXXXXXXXXXPXXXXXXXXXX
XXXXXXXXXPPPPPPPPPPPPPPPPPPPPPXXXXXXXXXX
XXXXXXXXXXXXXXXXXXXPXXXXXXXXXXXXXXXXXXXX
XXXXXXXXXXXXXXXXXXXPXXXXXXXXXXXXXXXXXXXX
XXXXXXXXXXXXXXXXXXXPXXXXXXXXXXXXXXXXXXXX
XXXXXXXRTTXXXXXXXXXPXXXXXXXXXXXXXXXXXXXX
XXXXXTTTTTTXXXXXXXXPXXXXXXXXXXXXXXXXXXXX
XXXXXXTTRTXXXXXXXXXPXXXXXXXXXXXXXXXXXXXT
XXXXXXTTTTXXXXXXXXXPXXXXXXXXXXXXXXXXTTTT
XXXXXXXXXXXXXXXXXXXPXXXXXXXXXXXXXTTXTTTT
XXXXXXXXXXXXXXXXXXXPXXXXXXXXTTTTTXXTTTTT
XXXXXXXXXXXXXXXXXXXEXXXXXXXTTTTTTXTTTTTT