XXXXXXXX
GPPPPPPE
XXXPXPXX
XXXPPPXX
XXXXXXXX
XXXXXXXX
XXXXXXXX
XXXXXXXX